{
  "Maps": [
      {
        "id": "debug-1",
        "xStart": 0,
        "yStart": 0,
        "angle": 0.78539816339,
        "arr": [[1, 0, 0, 0, 0, 0, 0, 0, 0, 0], 
        [0, 0, 0, 0, 0, 0, 0, 0, 0, 0], 
        [0, 0, 0, 0, 0, 0, 0, 0, 0, 0], 
        [0, 0, 0, 0, 0, 0, 0, 0, 0, 0], 
        [0, 0, 0, 0, 2, 2, 0, 0, 0, 0], 
        [0, 0, 0, 0, 2, 2, 0, 0, 0, 0], 
        [0, 0, 0, 0, 0, 0, 0, 0, 0, 0], 
        [0, 0, 0, 0, 0, 0, 0, 0, 0, 0], 
        [0, 0, 0, 0, 0, 0, 0, 0, 0, 0], 
        [0, 0, 0, 0, 0, 0, 0, 0, 0, 3]]
      },

      {
        "id": "debug-2",
        "xStart": 0,
        "yStart": 0,
        "angle": 0.78539816339,
        "arr": [[1, 0, 0, 0, 0, 0, 0, 0, 0, 0], 
        [0, 0, 0, 0, 0, 0, 0, 0, 0, 0], 
        [0, 0, 0, 0, 0, 0, 0, 0, 0, 0], 
        [0, 0, 0, 2, 2, 2, 2, 0, 0, 0], 
        [0, 0, 0, 2, 2, 2, 2, 0, 0, 0], 
        [0, 0, 0, 2, 2, 2, 2, 0, 0, 0], 
        [0, 0, 0, 2, 2, 2, 2, 0, 0, 0], 
        [0, 0, 0, 0, 0, 0, 0, 0, 0, 0], 
        [0, 0, 0, 0, 0, 0, 0, 0, 0, 0], 
        [0, 0, 0, 0, 0, 0, 0, 0, 0, 3]]
      }
  ]
}