{
  "Maps": [
      {
        "id": "debug-1",
        "xStart": 12,
        "yStart": 12,
        "angle": 0.78539816339,
        "arr": [[1, 0, 0, 0, 0, 0, 0, 0, 0, 0], 
        [0, 0, 0, 0, 0, 0, 0, 0, 0, 0], 
        [0, 0, 0, 0, 0, 0, 0, 0, 0, 0], 
        [0, 0, 0, 0, 0, 0, 0, 0, 0, 0], 
        [0, 0, 0, 0, 2, 2, 0, 0, 0, 0], 
        [0, 0, 0, 0, 2, 2, 0, 0, 0, 0], 
        [0, 0, 0, 0, 0, 0, 0, 0, 0, 0], 
        [0, 0, 0, 0, 0, 0, 0, 0, 0, 0], 
        [0, 0, 0, 0, 0, 0, 0, 0, 0, 0], 
        [0, 0, 0, 0, 0, 0, 0, 0, 0, 3]]
      },

      {
        "id": "debug-2",
        "xStart": 12,
        "yStart": 12,
        "angle": 0.78539816339,
        "arr": [[1, 0, 0, 0, 0, 0, 0, 0, 0, 0], 
        [0, 0, 0, 0, 0, 0, 0, 0, 0, 0], 
        [0, 0, 0, 0, 0, 0, 0, 0, 0, 0], 
        [0, 0, 0, 2, 2, 2, 2, 0, 0, 0], 
        [0, 0, 0, 2, 2, 2, 2, 0, 0, 0], 
        [0, 0, 0, 2, 2, 2, 2, 0, 0, 0], 
        [0, 0, 0, 2, 2, 2, 2, 0, 0, 0], 
        [0, 0, 0, 0, 0, 0, 0, 0, 0, 0], 
        [0, 0, 0, 0, 0, 0, 0, 0, 0, 0], 
        [0, 0, 0, 0, 0, 0, 0, 0, 0, 3]]
      },

      {
        "id": "roundabout-1",
        "xStart": 12,
        "yStart": 12,
        "angle": 0.78539816339,
        "arr": [[1, 0, 0, 0, 2, 2, 0, 0, 0, 3], 
        [0, 0, 0, 0, 2, 2, 0, 0, 0, 0], 
        [0, 0, 0, 0, 2, 2, 0, 0, 0, 0], 
        [0, 0, 0, 2, 2, 2, 2, 0, 0, 0], 
        [0, 0, 0, 2, 2, 2, 2, 0, 0, 0], 
        [0, 0, 0, 2, 2, 2, 2, 0, 0, 0], 
        [0, 0, 0, 2, 2, 2, 2, 0, 0, 0], 
        [0, 0, 0, 0, 0, 0, 0, 0, 0, 0], 
        [0, 0, 0, 0, 0, 0, 0, 0, 0, 0], 
        [0, 0, 0, 0, 0, 0, 0, 0, 0, 0]]
      },

      {
        "id": "parkour-1",
        "xStart": 12,
        "yStart": 12,
        "angle": 0,
        "arr": [[1, 0, 0, 0, 0, 0, 0, 0, 0, 0], 
        [0, 0, 0, 0, 0, 0, 0, 0, 0, 0], 
        [2, 2, 2, 2, 2, 2, 2, 2, 0, 0], 
        [0, 0, 0, 0, 0, 0, 0, 0, 0, 0], 
        [0, 0, 0, 0, 0, 0, 0, 0, 0, 0], 
        [0, 0, 2, 2, 2, 2, 2, 2, 2, 2], 
        [0, 0, 0, 0, 0, 0, 0, 0, 0, 0], 
        [0, 0, 0, 0, 0, 0, 0, 0, 0, 0], 
        [2, 2, 2, 2, 2, 2, 2, 2, 2, 0], 
        [3, 0, 0, 0, 0, 0, 0, 0, 0, 0]]
      },

      {
        "id": "max-1",
        "xStart": 108,
        "yStart": 36,
        "angle": -1.57079632679,
        "arr": [
        [0, 0, 0, 0, 0, 0, 0, 0, 0, 0], 
        [0, 2, 0, 2, 1, 2, 2, 2, 2, 0], 
        [0, 2, 0, 2, 2, 2, 0, 0, 0, 0], 
        [0, 2, 0, 0, 0, 2, 0, 2, 2, 0], 
        [0, 2, 2, 2, 0, 2, 0, 0, 2, 0], 
        [0, 2, 3, 2, 0, 2, 2, 2, 2, 0], 
        [0, 2, 0, 2, 0, 0, 0, 0, 2, 0], 
        [0, 2, 0, 2, 0, 2, 0, 0, 2, 0], 
        [0, 2, 0, 2, 0, 2, 2, 2, 2, 0], 
        [0, 2, 0, 0, 0, 0, 0, 0, 2, 0]]
      }
  ]
}